G1 G1 G1 G1 G1 F1 F1 F1 F1 F1 F1 F1 F1 F1 F1 F1 F1 F1 F1 F1 F1 F1 F1 F1 G1 G1 G1 F1 F1 F1
G1 G1 G1 G1 G1 F1 F1 G1 F1 F1 F1 G1 F1 F1 F1 F1 G1 G1 W1 G1 G1 G1 G1 G1 G1 G1 G1 F1 F1 F1
G1 G1 G1 G1 G1 F1 F1 G1 G1 F1 F1 G1 G1 G1 G1 F1 G1 G1 F1 F1 G1 F1 F1 F1 F1 F1 G1 G1 W1 G1
G1 G1 G1 G1 G1 F1 F1 G1 G1 G1 G1 G1 F1 F1 G1 G1 G1 F1 F1 F1 W1 F1 G1 G1 G1 F1 G1 F1 F1 G1
G1 G1 G1 G1 G1 G1 G1 G1 G1 G1 F1 F1 F1 F1 F1 F1 G1 G1 G1 F1 G1 F1 W1 F1 G1 F1 G1 G1 G1 G1
G1 G1 G1 G1 G1 G1 G1 G1 F1 F1 F1 G1 G1 G1 F1 F1 F1 F1 W1 F1 G1 G1 G1 F1 G1 F1 W1 F1 F1 F1
F1 G1 G1 F1 F1 F1 F1 F1 F1 F1 F1 G1 F1 G1 G1 G1 F1 F1 W1 F1 F1 F1 F1 F1 G1 F1 G1 F1 F1 G1
F1 G1 G1 F1 G1 F1 G1 F1 F1 F1 G1 G1 G1 G1 G1 G1 F1 G1 G1 G1 G1 F1 G1 G1 G1 F1 G1 F1 F1 G1
F1 G1 G1 F1 G1 F1 G1 F1 G1 G1 G1 G1 F1 F1 F1 G1 F1 F1 F1 W1 F1 F1 F1 F1 F1 F1 G1 F1 F1 G1
F1 G1 G1 F1 G1 G1 G1 F1 G1 F1 G1 G1 F1 F1 F1 G1 G1 G1 G1 G1 G1 G1 F1 F1 F1 F1 G1 F1 F1 G1
G1 G1 F1 F1 G1 F1 F1 G1 F1 G1 G1 W1 F1 F1 G1 G1 F1 F1 F1 F1 F1 G1 F1 F1 W1 F1 G1 G1 G1 G1
G1 G1 F1 F1 G1 F1 F1 G1 G1 G1 F1 F1 F1 F1 G1 G1 F1 G1 G1 G1 F1 G1 F1 W1 W1 F1 F1 W1 F1 G1
F1 G1 G1 F1 G1 F1 G1 G1 G1 G1 F1 F1 F1 F1 G1 F1 F1 F1 G1 G1 F1 G1 F1 F1 F1 F1 F1 F1 F1 G1
F1 G1 G1 F1 F1 F1 G1 G1 F1 F1 F1 F1 F1 F1 G1 F1 F1 F1 G1 G1 G1 G1 W1 G1 G1 G1 G1 G1 G1 G1
G1 G1 G1 G1 F1 F1 G1 G1 F1 F1 G1 G1 G1 F1 G1 F1 F1 F1 G1 G1 F1 G1 F1 F1 F1 F1 F1 F1 F1 G1
G1 G1 G1 G1 G1 F1 G1 G1 F1 F1 G1 F1 G1 F1 X1 F1 F1 F1 F1 F1 F1 G1 F1 F1 F1 G1 F1 F1 F1 W1
G1 G1 G1 G1 F1 F1 F1 G1 F1 F1 G1 F1 G1 F1 F1 F1 F1 G1 G1 G1 F1 F1 F1 F1 F1 G1 F1 F1 F1 G1
F1 G1 G1 F1 F1 F1 G1 G1 F1 F1 G1 F1 F1 F1 F1 F1 F1 G1 F1 F1 F1 F1 G1 F1 F1 G1 F1 G1 G1 G1
F1 G1 G1 F1 F1 F1 G1 G1 F1 F1 W1 F1 G1 G1 G1 F1 F1 W1 F1 F1 G1 W1 G1 G1 G1 G1 F1 G1 G1 F1
F1 G1 G1 F1 F1 F1 G1 G1 F1 F1 G1 G1 G1 F1 G1 G1 G1 G1 F1 F1 G1 F1 F1 F1 F1 G1 F1 G1 G1 F1
F1 G1 G1 F1 F1 F1 W1 W1 F1 F1 F1 F1 G1 G1 G1 F1 F1 G1 F1 G1 G1 G1 F1 F1 F1 G1 W1 G1 G1 F1
F1 F1 G1 F1 F1 W1 W1 W1 W1 W1 F1 F1 F1 G1 F1 F1 F1 G1 F1 G1 F1 G1 F1 F1 F1 G1 F1 G1 G1 G1
F1 G1 G1 F1 W1 W1 W1 W1 G1 W1 W1 F1 F1 W1 F1 F1 F1 G1 G1 G1 F1 G1 G1 F1 F1 F1 F1 F1 F1 W1
F1 G1 F1 F1 W1 W1 W1 W1 W1 G1 W1 W1 F1 G1 F1 F1 F1 F1 F1 F1 F1 G1 G1 G1 G1 F1 F1 F1 F1 G1
F1 G1 G1 F1 W1 W1 W1 W1 W1 W1 W1 W1 W1 G1 F1 F1 G1 G1 G1 G1 F1 W1 F1 G1 G1 G1 W1 G1 G1 G1
F1 F1 G1 F1 F1 W1 W1 W1 W1 W1 W1 W1 F1 G1 G1 G1 G1 F1 F1 G1 W1 W1 F1 F1 F1 F1 F1 F1 F1 F1
F1 G1 G1 F1 F1 F1 F1 F1 F1 F1 F1 F1 F1 G1 F1 F1 F1 F1 F1 F1 F1 F1 F1 F1 F1 G1 G1 G1 G1 G1
F1 G1 G1 G1 G1 G1 G1 G1 G1 G1 G1 F1 G1 G1 G1 G1 G1 G1 G1 G1 G1 G1 G1 G1 G1 G1 G1 G1 G1 G1
F1 G1 G1 G1 F1 F1 G1 G1 G1 G1 G1 G1 G1 G1 G1 G1 G1 G1 G1 G1 G1 G1 G1 G1 G1 G1 G1 G1 G1 G1
F1 F1 F1 F1 F1 F1 F1 F1 F1 F1 F1 F1 F1 F1 F1 F1 F1 F1 F1 F1 F1 F1 F1 F1 F1 G1 G1 G1 G1 G1
